1111111111111111111111
1E0000000C000010C00001
10000000W0000010001001
1C00000000000011110001
10011100000P0000000001
1C01C000000000000C0001
1111111111111111111111
